AAA	!
AAC	#
AAG	$
AAT	%
AA_	&
ACA	(
ACC	)
ACG	*
ACT	+
AC_	-
AGA	.
AGC	0
AGG	1
AGT	2
AG_	3
ATA	4
ATC	5
ATG	6
ATT	7
AT_	8
A__	9
CAA	;
CAC	<
CAG	=
CAT	?
CA_	A
CCA	B
CCC	C
CCG	D
CCT	E
CC_	F
CGA	G
CGC	H
CGG	I
CGT	J
CG_	K
CTA	L
CTC	M
CTG	N
CTT	O
CT_	P
C__	Q
GAA	R
GAC	S
GAG	T
GAT	U
GA_	V
GCA	W
GCC	X
GCG	Y
GCT	Z
GC_	[
GGA	]
GGC	_
GGG	a
GGT	b
GG_	c
GTA	d
GTC	e
GTG	f
GTT	g
GT_	h
G__	i
TAA	j
TAC	k
TAG	l
TAT	m
TA_	n
TCA	o
TCC	p
TCG	q
TCT	r
TC_	s
TGA	t
TGC	u
TGG	v
TGT	w
TG_	x
TTA	y
TTC	z
TTG	{
TTT	|
TT_	}
T__	~
